NO ./texture/image_n.png
SO ./texture/image_s.png
WE ./texture/image_e.png
EA ./texture/image_w.png

F 209,243,197
C 137,207,240

        1111111111111111111111111
        1000001000000000000000001
        1100001000000000000000001
        1000001000000000000000001
111111111000001100000000000000001
100000000000000100000000000001111
10000000000000E11111110000000001
1000000000000001    110000000001
1000000000000001 111100000001111
1000000000000001 1010100000001
1000000000000001 1000000000001
1100000111010101 1111011111111
11110111 1110111 101111010001
11110011 1111111 111111111111
   10101 1111111
   11111